NO ./img/N.xpm
SO ./img/S.xpm
WE ./img/W.xpm
EA ./img/E.xpm

F 102,204,204
C 192,192,192

11111111111111111
10010000000000001
10010011111011011
10000000000001001
10000100000001001
100000000N0001001
10000000000001001
10000000000001001
11111111111111111