NO ./path_to_the_north_texture
SO ./path_to_the_south_texture

WE ./path_to_the_west_texture	
EA ./path_to_the_east_texture	

F 220,100,0	
C 225,30,255	

111111111111111
1000000000000011
100000000000S11
111111111111111