NO ./img/coin.xpm
SO ./img/trash.xpm
WE ./img/player.xpm
EA ./img/wall.xpm

F 220,100,0
C 225,30,255

11111111111111111
10010000000000001
1001001W110011011
10000000000001001
11111111111111111