NO ./img/coin.xpm
SO ./img/trash.xpm
WE ./img/player.xpm
EA ./img/wall.xpm

F 220,100,0
C 225,30,255

11111111111111111
10010000000000001
10010010110011011
10000000000001001
100001000N0001001
10000000000001001
10000000000001001
10000000000001001
11111111111111111