NO ./img/N.xpm
SO ./img/S.xpm
WE ./img/W.xpm
EA ./img/E.xpm

F 220,100,0
C 225,30,255

11111111111111111
10010000000000001
10010011111011011
10000000D0D001001
10000100000001001
100000000N0001001
10000000000001001
10000000000001001
11111111111111111